
F     5     ,6,  7




C 45,15,8



11 111  111
  1111111011
 11011111111
1111