
NO   textures/wood_wall1.xpm
EA   textures/wood_sprite1.xpm
SO    textures/wood_sprite2.xpm
WE    textures/wood_wall1.xpm

F     5     ,6,  7




C 45,15,8



11 111  111 1 1
  1111111011011
 1100001000011
 1110000S0111111
 111111111